OOOOOOOO
O      O
O OOOO O
O    O O
O OOOO X
O    OOO
OO O  OO
OO+OOOOO
