OOOOOOOOOOO
O       O O
O O O OOO X
O O     O O
+ O OOOOO O
OOO*OOO O O
O       O O
O OOOOOOO O
O    *    O
OOOOOOOOOOO
