OOOOOOOOOOOO
O   O*     O
O OOO OOOO O
O O O O  O X
O*O O O OOOO
O O O O OO O
O O O*O OO O
O   O O*OO O
O O O O OO +
O O O O OO O
O O *   *  O
OOOOOOOOOOOO
