OOOOOOOOOOOOOOO
OO   O  *     X
OO*OOO OOOO OOO
OO   O    O O O
OO OOOOOO OOO O
OO O     *    O
OO O OOOOOOOOOO
OO O*        OO
OO*O OO OO OO O
OO O OOOOOOOO O
OO O O     *  O
+    O OOO OOOO
OO OOO OOO OOOO
OO *    *    OO
OOOOOOOOOOOOOOO
